R 1920 1080
NO ./textures/north.xpm
SO ./textures/south.xpm
WE ./textures/west.xpm
EA ./textures/east.xpm

S ./path_to_the_sprite_texture
F 220,100,0
C 225,30,0

111111111111111
1S01111111111111
11111111111111111
111111111111111
