R 1920 1080
NO ./textures/north.xpm
SO ./textures/south.xpm
WE ./textures/west.xpm
EA ./textures/east.xpm

S ./path_to_the_sprite_texture
F 220,100,0
C 225,30,0

1111111111
10000000N1
1000000001
1111111111
