R 800 600
NO ./assets/redbrick.xpm
SO ./assets/sand.xpm
WE ./assets/stone.xpm
EA ./assets/wood.xpm

S ./assets/mossy.xpm
C 255,200,200
F 122,122,122

11111111111111111
11111110000000011
10000000000000001
10200002000001011
100N0000000000001
10002000200010001
10000000000000001
10202020002020101
10000000000000001
10002000200200001
10000000000000001
10200000200002001
10000000000000001
11111111111111111
